?###?#######?#########?###########?###?#?
#...#.......#.........#...........#...#.#
#.#.###.#.###.###.###.###.#.#####.#.#.#.#
#.#...#.#.......#.#.....#.#.#.....#.#.#.#
#.###.#########.#.#####.###.#.#####.#.#.#
#.#O#.#.....#...#...#.......#.#...#.#.#.#
#.#.#.#.###.#######.#########.#.#.#.#.#.#
#.#.....#.#...#...#...#.....#...#...#.#.#
#.#######.###.#.#.###.#.#.######?####.#.#
#.......#...#...#.#...#.#.......#...#...#
#.#####.#.#######.#.##?####.#####.#.###.#
#.#...#.#.........#...#...#.......#...#.#
#.###.#.###.#########.#.#.###.#####.#.#.#
#.....#...#.#...#.....#.#...#.....#.#.#.#
?####.###.#.#.#.###.#.#.###.#######.#.#.#
#.....#...#...#.....#.#.#.#...#.....#.#.#
#.#####.##?####.####?##.#.###.#.#######.#
#.#...#...#.....#...#...#.#...#.#.......#
#.###.###.###.###.#.#.###.#.###.#.######?
#.......#...#.#...#...#...#...#.#.....#.#
#.######?##.#.#.#######.#####.#.#####.#.#
#.#.....#...#.#......x#.#.....#.#.....#.#
?##.###.#.###.#########.#.#####.#.#####.#
#...#...#.#.#...#...#...#.....#.#.#...#.#
#.###.###.#.#.###.#.#.#.#####.#.#.#.#.#.#
#.#.......#...#...#...#.....#.#.#...#.#.#
#.#########.###.######?####.#.#.#####.#.#
#.#.....#...#.#.#.....#...#...#.....#.#.#
#.#.###.#.###.#.#.#.###.#.#####.###.#.#.#
#.#.#.#.#.#...#.#.#.#...#.....#.#...#...#
#.#.#.#.#.###.#.###.#.#####.#.#.#.#####.#
#.#...#.#...#.#...#.......#.#.#.#.#.....#
#.#.###.###.#.###.#######.#.#.###.#.####?
#.#.#...#.......#...#.....#.#.#...#.#...#
#.#.#.#####.####?##.#.#####.#.#.#.#.#.#.#
#...#.#...#.#...#...#.#.#...#...#.#.#.#.#
?####.#.#.###.#.#.###.#.#.##?####.#.###.#
#...#...#.....#...#.#...#...#...#.#...#.#
#.#.###############.###.###.#.#.#####.#.#
#.#.......................#...#.........#
?#?#######################?###?#########?